NO texture/first.xpm
SO texture/wall.xpm
WE texture/wall2.xpm
EA texture/wall3.xpm

F 255,223,0
C  0,77       ,      255

111111111
100000001           11111111
10000E0011111111111110000001
1000000000000000000010000001
1100000011111111111111111001
1000000000000000000111110011
1000000000000000000011111001        1111
1111100111111000000011111001111111111001
1100000011111100000001111000000000000001
1100000111111111000000000000000000000001
1111111111111111000001111000000000000001
1111111111111111111111111111111111111111
